######################
#...#.#.###.....#...##
##....#.....##.#.....#
###..#....Z.#.#......#
#.###......#........##
#.....#..#.#..#......#
#.......##..#...#..###
##.#....##.........#.#
#.....##..........#.##
##.....###.......##..#
#.###....#...........#
#..##..#..#.......#..#
#...#...#...A........#
#..#................##
###..#.#..#..........#
#....#.....#.#.....#.#
##........#....#.##..#
##.....#.#..#.#......#
#.#.....#.......#....#
######################
