######################
#...#.#.###.....#...##
##....#.....##.#.....#
###..#....Z.#.#......#
#.###.....+#........##
#.....#..#+#..#......#
#.......##+.#...#..###
##.#....##+........#.#
#.....##..+.......#.##
##.....###+......##..#
#.###....#+..........#
#..##..#..#+......#..#
#...#...#...A........#
#..#................##
###..#.#..#..........#
#....#.....#.#.....#.#
##........#....#.##..#
##.....#.#..#.#......#
#.#.....#.......#....#
######################
